






          SO ./textures/brick.xpm           




          R 10 10



WE ./textures/wood.xpm


EA      ./textures/nnn.xpm


S          ./textures/cactus.xpm


   NO./textures/eagle.xpm         

               F           50   ,    60     ,          70



          C          0  ,   100        ,      180     



   11111
   10001                               1111111
   10001                               1000001
   100011111                           100S001
   1000200011            111    11111111000001
   1000000001111111111111101111110000000000001
   1000000001000000020000000000000000000100001
   1000000001000000000000000000000000000120001
   1000000000000001111000000000111111110100001
  11111100000000001  100000000010000001110002111
  1000000000100000111100000000000000000000000021
  1000000000100011111111111111111111011111111111
  1000000000100000000000000000000001000020000001
  1000000001111111100000000000010000000000000001
  1000000001      100000000100011111110000000001
  1101110001      10000000010001     10000000111
   10111111111111110000000010001     100000001
   10111   100000000000000010001     100000001
   10001   100000000001111110001     100011111
  110001111101111110001000000001     100000001
  100000000001    10001000000001     120000001
  100000000201    10001000000001     100000001
  111110111111    100010011111111111110111000111
      101         10001001     10000000001000001
      101         10001001     12000000001000001
    111011        10001001     10000000001000001
   11000011       10001001     10000011111000001
   12000001       10000001     10000000000000001
   11110001      1100000011111110000000111111111
   10000001      1000000000000000000000000000001
   100000011111111000000111100011111111000111111
   1000000000000000000011  1100120000011111
   100111111111111200001    10010000001
   10000001      10000011  110010000001
   10000001      1100000111100010000001
   10000001       100000000000010000001
   10000011       100000000000010000001
   1000001  111   100000000000010000021
   100000111101   100111111111110001111
   100000000001   100000010000000001
   100010000001111100000010000000001
  1100010000000010000000010000000001
  1000111100000000000000010000000001
  1000000000000010000000000000000001
  1000000000000010000000000000000001
  1111111111111111111111111111111111

